1000100100
0110111100
0001010100
0110101101
0111110100
0110011010
0011000100
0010001010
0010010100
0100110000
