1111111111
1111111111
1111111111
0110101101
0111110100
0110011010
1011000100
1010001010
0010010100
1100110000
