0000100100
0110000100
0001010100
0110000101
0100010100
0100010000
0001000100
0010001000
0000010000
0100110000
