C00010010C
0110000100
0001010100
0110000101
0100010100
010000000E
C0010001C0
0010001000
00P00100C0
C100110000
