E000010001
100100C000
0P00000010
0110101101
011011010C
0110011010
1011000100
1010C01010
C000000100
110C1100C0
