10C0100100
0100111100
E00101C100
0100100101
0101110100
0100010010
001100C100
000000101C
0010C00100
01001100P0
